32	24																														
9	9	9	9	9	9	9	9	9	9	9	9	9	9	9	9	9	9	9	9	9	9	9	9	9	9	9	9	9	9	9	9
9	2	0	7	0	6	0	1	0	10	0	5	0	7	0	6	0	5	0	2	0	3	0	10	0	1	0	7	0	2	0	9
9	2	0	7	0	6	0	1	0	0	0	5	0	7	0	6	0	5	0	2	0	3	0	0	0	1	0	7	0	2	0	9
9	8	0	8	0	6	0	1	0	3	0	5	0	7	0	10	0	5	0	2	0	3	0	6	0	1	0	7	0	2	0	9
9	2	0	7	0	6	0	1	0	3	0	5	0	7	0	0	0	5	0	2	0	3	0	6	0	1	0	7	0	2	0	9
9	2	0	7	0	6	0	1	0	3	0	5	0	7	0	6	0	5	0	2	0	3	0	6	0	1	0	7	0	2	0	9
9	2	0	7	0	6	0	1	0	3	0	5	0	7	0	6	0	5	0	2	0	3	0	6	0	1	0	7	0	2	0	9
9	2	0	7	0	6	0	1	0	3	0	5	0	7	0	6	0	5	0	2	0	3	0	6	0	1	0	7	0	2	0	9
9	2	0	7	0	6	0	1	0	3	0	5	0	7	0	6	0	5	0	2	0	3	0	6	0	1	0	8	0	8	0	9
9	2	0	7	0	6	0	1	0	3	0	5	0	7	0	6	0	5	0	2	0	3	0	6	0	1	0	7	0	2	0	9
9	2	0	7	0	6	0	1	0	3	0	5	0	7	0	6	0	5	0	2	0	3	0	6	0	1	0	7	0	2	0	9
9	0	0	0	0	0	0	0	0	0	0	0	0	0	0	0	0	0	0	0	0	0	0	0	0	0	0	0	0	0	0	9
9	0	0	0	0	0	0	0	0	0	0	0	0	0	0	0	0	0	0	0	0	0	0	0	0	0	0	0	0	0	0	9
9	0	0	0	0	0	0	0	0	0	0	0	0	0	0	0	0	0	0	0	0	0	0	0	0	0	0	0	0	0	0	9
9	0	0	0	0	0	0	0	0	0	0	0	0	0	0	0	0	0	0	0	0	0	0	0	0	0	0	0	0	0	0	9
9	0	0	0	0	0	0	0	0	0	0	0	0	0	0	0	0	0	0	0	0	0	0	0	0	0	0	0	0	0	0	9
9	0	0	0	0	0	0	0	0	0	0	0	0	0	0	0	0	0	0	0	0	0	0	0	0	0	0	0	0	0	0	9
9	0	0	0	0	0	0	0	0	0	0	0	0	0	0	0	0	0	0	0	0	0	0	0	0	0	0	0	0	0	0	9
9	0	0	0	0	0	0	0	0	0	0	0	0	0	0	0	0	0	0	0	0	0	0	0	0	0	0	0	0	0	0	9
9	0	0	0	0	0	0	0	0	0	0	0	0	0	0	0	0	0	0	0	0	0	0	0	0	0	0	0	0	0	0	9
9	0	0	0	0	0	0	0	0	0	0	0	0	0	0	0	0	0	0	0	0	0	0	0	0	0	0	0	0	0	0	9
9	0	0	0	0	0	0	0	0	0	0	0	0	0	0	0	0	0	0	0	0	0	0	0	0	0	0	0	0	0	0	9
9	0	0	0	0	0	0	0	0	0	0	0	0	0	0	0	0	0	0	0	0	0	0	0	0	0	0	0	0	0	0	9
9	0	0	0	0	0	0	0	0	0	0	0	0	0	0	0	0	0	0	0	0	0	0	0	0	0	0	0	0	0	0	9